+++++++++++++++++++++
+   +   ++ ++   +++++
     +   +  +++++++++
++++   +        S +++
+++++++++++++++++++++